 , , , , , , , , , , , , , , , , , , , , , , , , , , , , , , , , , , , , , , , , , , , , , , , , , , , , , , , , , , , , , , , , , , , , , , , , , , , , , , , , , , , , , , , , , , , , , , , , , , , , , 
 , ,Y,Y,Y,Y,Y,Y,Y,Y,Y,Y,Y,Y,Y,Y,Y,Y,Y,Y,Y,Y,Y,Y,Y,Y,Y,Y,Y,Y,Y,Y,Y,Y,Y,Y,Y,Y,Y,Y,Y,Y,Y,Y,Y,Y,Y,Y,Y,Y,Y,Y,Y,Y,Y,Y,Y,Y,Y,Y,Y,Y,Y,Y,Y,Y,Y,Y,Y,Y,Y,Y,Y,Y,Y,Y,Y,Y,Y,Y,Y,Y,Y,Y,Y,Y,Y,Y,Y,Y,Y,Y,Y,Y,Y,Y,Y,Y,Y,Y,Y,Y
 , ,X, , , , , , , , , , , , , , , , , , , , , , , , , , , , , , , , , , , , , , , , , , , , , , , , , , , , , , , , , , , , , , , , , , , , , , , , , , , , , , , , , , , , , , , , , , , , , , , , , , ,X
 , ,X, , , , , , , , , , , , , , , , , , , , , , , , , , , , , , , , , , , , , , , , , , , , , , , , , , , , , , , , , , , , , , , , , , , , , , , , , , , , , , , , , , , , , , , , , , , , , , , , , , ,X
 , ,X, , , , , , , , , , , , , , , , , , , , , , , , , , , , , , , , , , , , , , , , , , , , , , , , , , , , , , , , , , , , , , , , , , , , , , , , , , , , , , , , , , , , , , , , , , , , , , , , , , ,X
 , ,X, , , , , , , , , , , , , , , ,|,|,|,|,|,|,|,|,|, , , , , , , , ,|,|,|,|,|,|,|,|,|,|,|, , , , , , , , ,|,|,|,|,|,|,|,|,|,|,|, , , , , , , , , ,|,|,|,|,|,|,|,|,|,|,|, , , , , , , , , , , , , , , , ,X
 , ,X, , , , , , , , , , , , , , , , , , , ,|, , , , , , , , , , , , ,|, , , , , , , , , , , , , , , , , , ,|, , , , , , , , , , , , , , , , , , , ,|, , , , , , , , , , , , , , , , , , , , , , , , , , ,X
 , ,X, , , , , , , , , , , , , , , , , , , ,|, , , , , , , , , , , , ,|, , , , , , , , , , , , , , , , , , ,|, , , , , , , , , , , , , , , , , , , ,|, , , , , , , , , , , , , , , , , , , , , , , , , , ,X
 , ,X, , , , , , , , , , , , , , , , , , , ,|, , , , , , , , , , , , ,|, , , , , , , , , , , , , , , , , , ,|, , , , , , , , , , , , , , , , , , , ,|, , , , , , , , , , , , , , , , , , , , , , , , , , ,X
 , ,X, , , , , , , , , , , , , , , , , , , ,|, , , , , , , , , , , , ,|, , , , , , , , , , , , , , , , , , ,|, , , , , , , , , , , , , , , , , , , ,|, , , , , , , , , , , , , , , , , , , , , , , , , , ,X
 , ,X, , , , , , , , , , , , , , , , , , , ,|, , , , , , , , , , , , ,|, , , , , , , , , , , , , , , , , , ,|, , , , , , , , , , , , , , , , , , , ,|, , , , , , , , , , , , , , , , , , , , , , , , , , ,X
 , ,X, , , , , , , , , , , , , , , , , , , ,|, , , , , , , , , , , , ,|,|,|,|,|,|,|,|,|,|,|, , , , , , , , ,|,|,|,|,|,|,|,|,|,|,|, , , , , , , , , ,|,|,|,|,|,|,|,|,|,|,|, , , , , , , , , , , , , , , , ,X
 , ,X, , , , , , , , , , , , , , , , , , , ,|, , , , , , , , , , , , ,|, , , , , , , , , , , , , , , , , , ,|, , , , , , , , , , , , , , , , , , , ,|, , , , , , , , , , , , , , , , , , , , , , , , , , ,X
 , ,X, , , , , , , , , , , , , , , , , , , ,|, , , , , , , , , , , , ,|, , , , , , , , , , , , , , , , , , ,|, , , , , , , , , , , , , , , , , , , ,|, , , , , , , , , , , , , , , , , , , , , , , , , , ,X
 , ,X, , , , , , , , , , , , , , , , , , , ,|, , , , , , , , , , , , ,|, , , , , , , , , , , , , , , , , , ,|, , , , , , , , , , , , , , , , , , , ,|, , , , , , , , , , , , , , , , , , , , , , , , , , ,X
 , ,X, , , , , , , , , , , , , , , , , , , ,|, , , , , , , , , , , , ,|, , , , , , , , , , , , , , , , , , ,|, , , , , , , , , , , , , , , , , , , ,|, , , , , , , , , , , , , , , , , , , , , , , , , , ,X
 , ,X, , , , , , , , , , , , , , , , , , , ,|, , , , , , , , , , , , ,|, , , , , , , , , , , , , , , , , , ,|, , , , , , , , , , , , , , , , , , , ,|, , , , , , , , , , , , , , , , , , , , , , , , , , ,X
 , ,X, , , , , , , , , , , , , , , ,|,|,|,|,|,|,|,|,|, , , , , , , , ,|,|,|,|,|,|,|,|,|,|,|, , , , , , , , ,|,|,|,|,|,|,|,|,|,|,|, , , , , , , , , ,|,|,|,|,|,|,|,|,|,|,|, , , , , , , , , , , , , , , , ,X
 , ,X, , , , , , , , , , , , , , , , , , , , , , , , , , , , , , , , , , , , , , , , , , , , , , , , , , , , , , , , , , , , , , , , , , , , , , , , , , , , , , , , , , , , , , , , , , , , , , , , , , ,X
 , ,X, , , , , , , , , , , , , , , , , , , , , , , , , , , , , , , , , , , , , , , , , , , , , , , , , , , , , , , , , , , , , , , , , , , , , , , , , , , , , , , , , , , , , , , , , , , , , , , , , , ,X
 , ,X, , , , , , , , , , , , , , , , , , , , , , , , , , , , , , , , , , , , , , , , , , , , , , , , , , , , , , , , , , , , , , , , , , , , , , , , , , , , , , , , , , , , , , , , , , , , , , , , , , ,X
 , ,X, , , , , , , , , , , , , , , , , , , , , , , , , , , , , , , , , , , , , , , , , , , , , , , , , , , , , , , , , , , , , , , , , , , , , , , , , , , , , , , , , , , , , , , , , , , , , , , , , , ,X
 , ,Y,Y,Y,Y,Y,Y,Y,Y,Y,Y,Y,Y,Y,Y,Y,Y,Y,Y,Y,Y,Y,Y,Y,Y,Y,Y,Y,Y,Y,Y,Y,Y,Y,Y,Y,Y,Y,Y,Y,Y,Y,Y,Y,Y,Y,Y,Y,Y,Y,Y,Y,Y,Y,Y,Y,Y,Y,Y,Y,Y,Y,Y,Y,Y,Y,Y,Y,Y,Y,Y,Y,Y,Y,Y,Y,Y,Y,Y,Y,Y,Y,Y,Y,Y,Y,Y,Y,Y,Y,Y,Y,Y,Y,Y,Y,Y,Y,Y,Y,Y
